....................
....................
.........GG.........
....................
.........---........
....................
....................
.........GGG........
....................
....................
....GGG.......GGG...
....###.......###...
..................X.
.1..................
####################
