................X...
....................
...--..........--...
....G.--............
...--..........--...
..........G....G....
...--....##....--...
....G...............
...--....G...G.--...
........###.--.G....
...--..G..GG...--...
....G..GGG..........
...--..........--...
.1..................
####################
